-- HUMAN RESOURCE MACHINE PROGRAM --
-- 03-Copy-Floor - SIZE 25/6 - SPEED 25/6 --


    COPYFROM 4
    COPYFROM 4
    COPYFROM 4
    COPYFROM 4
    COPYFROM 4
    COPYFROM 4
    COPYFROM 4
    COPYFROM 4
    COPYFROM 4
    COPYFROM 4
    COPYFROM 4
    COPYFROM 4
    COPYFROM 4
    COPYFROM 4
    COPYFROM 4
    COPYFROM 4
    COPYFROM 4
    COPYFROM 4
    COPYFROM 4
    COPYFROM 4
    OUTBOX  
    COPYFROM 0
    OUTBOX  
    COPYFROM 3
    OUTBOX  


